

NO   ./textures/north.xpm
SO ./textures/south.xpm
WE ./textures/west.xpm
EA ./textures/east.xpm


F  10,10,30

C  0 , 0 ,0




111111111111111111111111111111
10000000001100000000000000000111
100110000011100000001100000011011
1001000000000000000010001111111111111
1111111110110000011100000000000001
1000000000110000011101111111111111
1111011111111100110000001000110001
111101111111110011000100100011000111
1100000011S0000011000000100111110001
1000000000000000110000000000000000001
1000000000000000110101001000100000001
1100000111101011111011110011111111111
11110111 1110101 101111010001
11111111 1111111 111111111111
