EA ./textures/stone.xpm
C 0,128,128
F 255,0,0
NO ./textures/mossy.xpm
SO ./textures/redbrick.xpm
WE ./textures/wood.xpm
1111111111111111111111111111111111111111111
1000000000000000000000000000000000000000001
1000000000000000000000000000000000000000001
1000111111111111111111111111111111111111111
1000100000000001000000000111111111110000111
1000100000000001000000000111111111110000111
1000100000000001000000000000001111110000111
1000100000000001000000000000000001110000111
1000100000000001000000000000000000000000111
1000100000000000000000000000000000000000111
1000111111111111111111111111111111110000111
1000111111111111111111111111111111110000111
1000000000000000000000000000000000000000111
100000000000000000000000000S000000000000111
1111111111111111111111111111111111111111111
