NO   ./textures/bluestone.xpm
SO ./textures/south.xpm
WE ./textures/west.xpm
EA ./textures/east.xpm


F  225,30,0

C  220,100,0






        111111 1111111 11111111
        100001 1001101 1000000111
        1011011101110111000000111
        1001000000000000000000001
11111111101100000111000000N000001
100000000011000001110111111111111
11110111111111011100000010001
11110111111111011101010010001
11000000110101011100000010001
10000W00000000001100000010001
10000000000000001101010010001
1100000111010101111101111000111
11110111111101011101111010001
 1111111111111111111111111111
