RE 10 710
NO ./textures/no.xpm
SO ./textures/so.xpm
EA ./textures/ea.xpm
WE ./textures/we.xpm

C 134,65,160
F 78,78,78

11111111111111111
10000000000000001
10100000100000101
10000000000000001
10001000100010001
10000000000000001
10101010N01010101
10000000000000001
10001000100100001
10000000000000001
10100000100001001
10000000000000001
11111111111111111
