F 
SO ./textures/so.xpm
EA ./textures/ea.xpm


        WE              ./textures/we.xpm
C 225    ,   30,0

                NO                ./textures/no.xpm




                                        1111111111111111111111111
                                        1000000000110000000000001111111111111111111111111111111111111111
                                        1011000001110000000000000000000000000000000000000000000000000001
                                        1001000000000000000000001111111111111110111111111111111111111101
                                        1011000001110000000000001           1 111                    111
                                        1011000001110111111111111
                                        111111011100000010001
                                        111111011101010010001
                                        110101011100000000001
                                        100000001100000010001
                                        100000001101010010001
                                        11010100000101111000111
                                         11101011101111000001
                                         1111111 111111110111
                                                        101
                                                        101
                                                        101
                                                        101
                                                        101
                                                        101
                                                        101
                                                        101
                                                        101
                                                        1011111111111111111111111111111111
                                                        100000000000000000000000000000E001
                                                        1111111111111111111111111111111111
