NO   ./textures/no.xpm
SO ./textures/so.xpm
WE ./textures/we.xpm
EA ./textures/ea.xpm


F  0 , 0 ,0

C  0,0,50



111111111111
100000000001
10000000N001
1111011111111111
