NO ./textures/no.xpm
SO ./textures/so.xpm
WE ./textures/we.xpm
EA        ./textures/ea.xpm
     F     12, 220,    125
     C     56, 150,    49
1111111111
1111111111
1111111111
1111111111
1111111111
1111111111
1111111111
1111111111
