NO   ./textures/north.xpm
SO ./textures/south.xpm
WE ./textures/west.xpm
EA ./textures/east.xpm


F  0 , 0 ,0

C  0,0,50



111110111111
100000000001
10000000N001
1111111111111111
