NO   ./textures/no.xpm
SO ./textures/so.xpm
WE ./textures/we.xpm
EA ./textures/ea.xpm


F  05,30,0

C  00,100,0






1111111111
1000000001
1000000001
100000W001
1111111111110001
