NO ./textures/no.xpm
SO ./textures/so.xpm
WE ./textures/we.xpm
EA ./textures/ea.xpm
F 184,113,39
C 51,198,227

11111111
100000011
1101110011
1111  1001
1001010011
100N00001
100000001
11111111
