NO ./textures/no.xpm

SO ./textures/so.xpm
WE ./textures/we.xpm
EA        ./textures/ea.xpm


C 124,    e25, 12

     F     12, 220,    125

1111111111
1000000001
1111000001
1000000001
100N001001
1000001001
1000001001
1111111111
